###########################################################################################
#              #                             #  #  #           #     #  #  #     #     #  #
#   #########  ############   ######   ###   #  #  #  ######   ###   #  #  #   #########  #
#           #                 #        #     #     #  #              #     #              #
#  #######  #############  ####################### #  #  ##########  #     #  ########## ##
#  #     #  #           #  #                 #  #  #  #  #  #     #  #  #  #  #           #
#  #  #  #  #  #  ###   #  #  #############  #  #  #  #  #  ###   #  #  #  #  #  ##########
#  #  #  #  #  #  #     #  #  #  #        #  #  #  #  #  #        #  #  #  #  #        #   
#  #  ####  #  ##########  #  #  ###   #  #  #  #  #  #  #   ######  #  #     #     #  #   
#  #     #  #              #           #  #  #  #  #  #  #           #  #     #  #  #     #
#  ####  #  ################  #############  #  #  #  #  #############  #  #  #  ##########
#     #  #                    #              #     #  #                 #  #  #        #  #
####  #  ######################  ##########  #  ####  #  ################  #  ######   #  #
#  #  #                    #     #     #  #  #  #     #  #        #        #     #     #  #
#  ###   #  ######   #  #########   #######  #        #           #  #     #           #  #
#                                                     #                    #     #        #
###########################################################################################
