############################################################################
#   #     #   #        #                  #                                #
#   #         #        #                  #  ################### #####     #
#   #     #   #   #    #   #########      #                  #       #     #
#   #  ####   #   #    #           #      ##############     #       ### ###
#                 #    #           #                         #       #      
#   ###############    ####        #                         #       #      
#   #             #                #################    ######  ######## ###
#                 #                #                         #             #
#           #     #    #######     #                         #   ######   ##
#   #       #     #    #     #     #   #######################   #         #
#   #       #     #    #     #     #                             #         #
#############     #    #           #                             #######  ##
#                 #    #     #     ####   #########    ###########  #      #
#  ################    #     #######      #                         #      #
#                      #                  # ################# #######      #
#                      #                  #                                #
############################################################################
