#################################################################################################
#                                                                                               # 
#                                                                                               # 
#                  ###                                                                          # ##################                                                                              # #             #                                                                                 #
#                                                                                               #
#                                                                                               #
#                                                                                                                                                                                   
#                                                                                                                                                                                                                                           # #       #                                                      # #                              #        #       #                                                      #                        #
#        #       #                                                      #                        #
#        #       #                                                      #                        #
#        #       #                                                      #                        #
#        #       #                                                      #                        #
#########################################################################     ###################
