############################################################################
#       #                                                                  #
#       #                                                                  #
#       ##############      ##############                                 #
#                    #                   #                                 #
#                    #                   #                                 #
#################    #                   #                                 #
#               #    ################    #                                 #  
#               #    #                   #                                 #
#   ########    #    #  ##################                                 #
#          #    #    #           #              ############################
#          #         #           #              #                          #
#          #         #           #       ########                          #
#          ################      #       #      #                          #
#          #         #           #    ####      #                          #
#                                #                                          
#          #         #           #                                          
############################################################################
