#################################################
#       #                                       #
#       #                                       #
#       ##############      ##############      #
#                    #                   #      #
#                    #                   #      #
#################    #                   #      #
#               #    ################    #      #  
#               #    #                   #      #
#   ########    #    #  ##################      #
#          #    #    #           #              #
#          #         #           #              #
#          #         #           #       ########
#          ################      #       #      #
#          #         #           #    ####      #
#                                #              
#          #         #           #               
#################################################
